ancorauna - Ancora una! Dove la metto!!...Culo
arrivoarrivo - Franz...
cazzodibudda - Cazzo di budda
cazzomene - Io sono vaccinato, cazzo me ne frega...
daccordissimo - No no no, con calma, su questo sono daccordissimo
demenza - La demenza di un'uomo
fiammeinferno - ho capito maaa, mica devi fare le fiamme dell'inferno
firstlesson - First lesson, please..lesson number one
fuoridalmondo - Io sono fuori dal mondo signori
gioielli - Non mi tastate i gioielli
imparatounafava - Mi sembra che tu non abbia imparato proprio una fava..
instructions - Mostra una breve guida su come utilizzare il bot
lacipolla - La cipolla!!!
lavorogiusto - Il lavoro va pagato..Quello giusto va pagato!!!
lesbiche - Amore, siete due lesbiche..
losquirt - Veniva giu lo squirt
motivazioniinternet - Io non soffro di non avere internet per comunicare con il mondo..per giocare..No!!! Per non poter scaricare i film!!!
noprogrammato - No grazie, non sono programmato a tal fine
personapulita - Sono desolato per lei ma, sono una persona pulita io
porcoladro - Porco Ladro!!!
qualitaolive - Ah, la qualita delle mie olive e molto buona
randomcard - invia in chat una carta di hearthstone del set calandrico
risata - Hi hi hi hi hi
sonocosternato - Sono Costernato
stocazzo - Stocazzo, risata
unoduetre - 1..2..3..e viva la figa!!!
vaginadepilata - La vagina depilata
wha - Wha!
whawha_fallout4 - Whaaawhaaa io non posso giocarci cazzo, NON HO INTERNET!!!
whawha_short - Whaaawhaaa
